{
  "map": {
    "tiles": [

      [ 1, 1, 1, 1, 1, 1, 1 ],
      [ 1, 0, 1, 0, 0, 0, 1 ],
      [ 1, 0, 2, 0, 2, 1, 1 ],
      [ 1, 2, 1, 1, 0, 0, 1 ],
      [ 1, 1, 0, 1, 1, 1, 1 ],
      [ 1, 1, 2, 0, 1, 0, 1 ],
      [ 1, 1, 0, 1, 0, 1, 0 ]


    ],
    "zerogravity": [
      [ 0, 0, 0, 0, 0, 0, 0 ],
      [ 0, 0, 0, 0, 0, 0, 0 ],
      [ 0, 0, 0, 0, 0, 0, 0 ],
      [ 0, 0, 0, 0, 0, 0, 0 ],
      [ 0, 0, 0, 0, 0, 0, 0 ],
      [ 0, 0, 0, 0, 0, 0, 0 ],
      [ 0, 0, 0, 0, 0, 0, 0 ]
    ]
  },
  "player": {

    "row": 0,
    "column": 0,
    "direction": 1

  },
  "child": {

    "row": 0,
    "column": 1
  }
}