{
  "map": {
    "tiles": [

      [ 0, 0, 0, 0, 0, 0, 0 ],
      [ 0, 1, 1, 0, 0, 0, 0 ],
      [ 0, 1, 1, 1, 1, 0, 0 ],
      [ 0, 1, 1, 2, 0, 1, 0 ],
      [ 0, 0, 0, 0, 3, 0, 0 ],
      [ 0, 0, 0, 0, 0, 0, 0 ],
      [ 0, 0, 0, 0, 0, 0, 0 ]


    ],
    "zerogravity": [
      [ 0, 0, 0, 0, 0, 0, 0 ],
      [ 0, 0, 0, 0, 0, 0, 0 ],
      [ 0, 0, 0, 0, 0, 0, 0 ],
      [ 0, 0, 0, 0, 0, 0, 0 ],
      [ 0, 0, 0, 0, 0, 0, 0 ],
      [ 0, 0, 0, 0, 0, 0, 0 ],
      [ 0, 0, 0, 0, 0, 0, 0 ]
    ]
  },
  "player": {
    "row": 2,
    "column": 1,
    "direction": 1

  },
  "child": {
    "row": 2,
    "column": 3
  }
}