{
  "map": {
    "tiles": [

      [ 0, 0, 0, 3, 0, 0, 0 ],
      [ 0, 0, 4, 4, 2, 0, 0 ],
      [ 0, 0, 4, 4, 1, 0, 0 ],
      [ 0, 1, 4, 4, 1, 0, 0 ],
      [ 0, 1, 4, 4, 1, 0, 0 ],
      [ 0, 0, 0, 0, 0, 0, 0 ],
      [ 0, 0, 0, 0, 0, 0, 0 ]


    ],
    "zerogravity": [
      [ 0, 0, 0, 0, 0, 0, 0 ],
      [ 0, 0, 0, 0, 0, 0, 0 ],
      [ 0, 0, 0, 0, 0, 0, 0 ],
      [ 0, 0, 0, 0, 0, 0, 0 ],
      [ 0, 0, 0, 0, 0, 0, 0 ],
      [ 0, 0, 0, 0, 0, 0, 0 ],
      [ 0, 0, 0, 0, 0, 0, 0 ]
    ]
  },
  "player": {
    "row": 1,
    "column": 4,
    "direction": 1

  },
  "child": {
    "row": 4,
    "column": 2
  }
}