{
  "map": {
    "tiles": [
      [ 0, 0, 0, 0, 0, 0, 0 ],
      [ 0, 0, 1, 1, 1, 1, 0 ],
      [ 0, 0, 4, 0, 4, 4, 0 ],
      [ 0, 2, 1, 3, 2, 1, 0 ],
      [ 0, 0, 1, 1, 1, 1, 0 ],
      [ 0, 0, 2, 0, 0, 0, 0 ],
      [ 0, 0, 0, 0, 0, 0, 0 ]


    ],
    "zerogravity": [
      [ 0, 0, 0, 0, 0, 0, 0 ],
      [ 0, 0, 0, 0, 0, 0, 0 ],
      [ 0, 0, 0, 0, 0, 0, 0 ],
      [ 0, 0, 0, 0, 0, 0, 0 ],
      [ 0, 0, 0, 0, 0, 0, 0 ],
      [ 0, 0, 0, 0, 0, 0, 0 ],
      [ 0, 0, 0, 0, 0, 0, 0 ]
    ]
  },
  "player": {
    "row": 2,
    "column": 4,
    "direction": 1

  },
  "child": {
    "row": 5,
    "column": 4
  }
}