{
  "map": {
    "tiles": [

      [ 0, 0, 1, 0, 0, 0, 0 ],
      [ 0, 0, 1, 0, 0, 0, 0 ],
      [ 0, 4, 4, 4, 1, 0, 0 ],
      [ 0, 4, 4, 4, 2, 0, 0 ],
      [ 0, 1, 1, 3, 0, 0, 0 ],
      [ 0, 0, 0, 0, 0, 0, 0 ],
      [ 0, 0, 0, 0, 0, 0, 0 ]


    ],
    "zerogravity": [
      [ 0, 0, 0, 0, 0, 0, 0 ],
      [ 0, 0, 0, 0, 0, 0, 0 ],
      [ 0, 0, 0, 0, 0, 0, 0 ],
      [ 0, 0, 0, 0, 0, 0, 0 ],
      [ 0, 0, 0, 0, 0, 0, 0 ],
      [ 0, 0, 0, 0, 0, 0, 0 ],
      [ 0, 0, 0, 0, 0, 0, 0 ]
    ]
  },
  "player": {
    "row": 4,
    "column": 2,
    "direction": 1

  },
  "child": {
    "row": 2,
    "column": 0
  }
}