{
  "map": {
    "tiles": [

      [ 1, 1, 1, 1, 1, 1, 1 ],
      [ 1, 1, 1, 1, 1, 1, 1 ],
      [ 1, 1, 1, 1, 1, 1, 1 ],
      [ 1, 2, 1, 2, 1, 2, 1 ],
      [ 1, 1, 1, 1, 1, 1, 1 ],
      [ 1, 1, 1, 1, 1, 1, 1 ],
      [ 1, 1, 1, 1, 1, 1, 1 ]


    ],
    "zerogravity": [
      [ 0, 0, 0, 0, 0, 0, 0 ],
      [ 0, 0, 0, 0, 0, 0, 0 ],
      [ 0, 0, 0, 0, 0, 0, 0 ],
      [ 0, 0, 0, 0, 0, 0, 0 ],
      [ 0, 0, 0, 0, 0, 0, 0 ],
      [ 0, 0, 0, 0, 0, 0, 0 ],
      [ 0, 0, 0, 0, 0, 0, 0 ]
    ]
  },
  "player": {

    "row": 1,
    "column": 1,
    "direction": 1

  },
  "child": {

    "row": 1,
    "column": 2
  }
}