{
  "map": {
    "tiles": [

      [ 0, 0, 0, 0, 0, 0, 0 ],
      [ 0, 1, 1, 1, 0, 0, 0 ],
      [ 0, 1, 1, 1, 0, 0, 0 ],
      [ 0, 0, 0, 0, 0, 0, 0 ],
      [ 0, 1, 1, 1, 0, 0, 0 ],
      [ 0, 1, 1, 3, 0, 0, 0 ],
      [ 0, 0, 0, 0, 0, 0, 0 ]


    ],
    "zerogravity": [
      [ 0, 0, 0, 0, 0, 0, 0 ],
      [ 0, 0, 0, 0, 0, 0, 0 ],
      [ 0, 0, 0, 0, 0, 0, 0 ],
      [ 0, 0, 0, 0, 0, 0, 0 ],
      [ 0, 0, 0, 0, 0, 0, 0 ],
      [ 0, 0, 0, 0, 0, 0, 0 ],
      [ 0, 0, 0, 0, 0, 0, 0 ]
    ]
  },
  "player": {

    "row": 1,
    "column": 2,
    "direction": 1

  },
  "child": {
    "row": 3,
    "column": 1

  }
}