{
  "map": {
    "tiles": [

      [ 1, 1, 1, 1, 1, 1, 1 ],
      [ 1, 4, 4, 4, 3, 1, 1 ],
      [ 1, 1, 4, 4, 4, 2, 1 ],
      [ 1, 1, 4, 4, 0, 4, 1 ],
      [ 1, 1, 4, 4, 4, 4, 1 ],
      [ 1, 1, 4, 0, 3, 4, 0 ],
      [ 1, 1, 1, 4, 0, 4, 0 ]


    ],
    "zerogravity": [
      [ 0, 0, 0, 0, 0, 0, 0 ],
      [ 0, 0, 0, 0, 0, 0, 0 ],
      [ 0, 0, 0, 0, 0, 0, 0 ],
      [ 0, 0, 0, 0, 0, 0, 0 ],
      [ 0, 0, 0, 0, 0, 0, 0 ],
      [ 0, 0, 0, 0, 0, 0, 0 ],
      [ 0, 0, 0, 0, 0, 0, 0 ]
    ]
  },
  "player": {

    "row": 1,
    "column": 1,
    "direction": 1

  },
  "child": {

    "row": 1,
    "column": 2
  }
}