{
  "map": {
    "tiles": [

      [ 0, 0, 0, 0, 0, 0, 0 ],
      [ 0, 1, 1, 1, 1, 1, 0 ],
      [ 0, 1, 0, 1, 1, 1, 0 ],
      [ 0, 1, 4, 4, 4, 1, 0 ],
      [ 0, 1, 2, 0, 2, 1, 0 ],
      [ 0, 1, 1, 3, 1, 1, 0 ],
      [ 0, 0, 0, 0, 0, 0, 0 ]


    ],
    "zerogravity": [
      [ 0, 0, 0, 0, 0, 0, 0 ],
      [ 0, 0, 0, 0, 0, 0, 0 ],
      [ 0, 0, 0, 0, 0, 0, 0 ],
      [ 0, 0, 0, 0, 0, 0, 0 ],
      [ 0, 0, 0, 0, 0, 0, 0 ],
      [ 0, 0, 0, 0, 0, 0, 0 ],
      [ 0, 0, 0, 0, 0, 0, 0 ]
    ]
  },
  "player": {

    "row": 1,
    "column": 1,
    "direction": 1

  },
  "child": {

    "row": 5,
    "column": 3
  }
}