{
  "map": {
    "tiles": [

      [ 0, 0, 0, 0, 0, 0, 0 ],
      [ 0, 4, 4, 4, 4, 4, 0 ],
      [ 0, 4, 4, 4, 4, 2, 0 ],
      [ 0, 4, 2, 3, 4, 4, 0 ],
      [ 0, 4, 4, 4, 4, 4, 0 ],
      [ 0, 4, 4, 4, 4, 4, 0 ],
      [ 0, 0, 0, 0, 0, 0, 0 ]


    ],
    "zerogravity": [
      [ 0, 0, 0, 0, 0, 0, 0 ],
      [ 0, 0, 0, 0, 0, 0, 0 ],
      [ 0, 0, 0, 0, 0, 0, 0 ],
      [ 0, 0, 0, 0, 0, 0, 0 ],
      [ 0, 0, 0, 0, 0, 0, 0 ],
      [ 0, 0, 0, 0, 0, 0, 0 ],
      [ 0, 0, 0, 0, 0, 0, 0 ]
    ]
  },
  "player": {
    "row": 3,
    "column": 4,
    "direction": 1

  },
  "child": {
    "row": 3,
    "column": 2
  }
}