{
  "map": {
    "tiles": [

      [ 0, 0, 0, 0, 0, 0, 0 ],
      [ 0, 1, 1, 1, 1, 1, 0 ],
      [ 0, 1, 1, 1, 1, 1, 0 ],
      [ 0, 1, 2, 2, 2, 1, 0 ],
      [ 0, 1, 2, 3, 2, 1, 0 ],
      [ 0, 1, 1, 1, 1, 1, 0 ],
      [ 0, 0, 0, 0, 0, 0, 0 ]


    ],
    "zerogravity": [
      [ 0, 0, 0, 0, 0, 0, 0 ],
      [ 0, 0, 0, 0, 0, 0, 0 ],
      [ 0, 0, 0, 0, 0, 0, 0 ],
      [ 0, 0, 0, 0, 0, 0, 0 ],
      [ 0, 0, 0, 0, 0, 0, 0 ],
      [ 0, 0, 0, 0, 0, 0, 0 ],
      [ 0, 0, 0, 0, 0, 0, 0 ]
    ]
  },
  "player": {
    "column": 3,
    "row": 5,
    "direction": 1

  },
  "child": {
    "column": 3,
    "row": 5
  }
}